000000000-
000030000-
000030000-
033353330-
000033330-
000030030-
033333330-
030000000-
033330000-
000030000-
000030000-
777141777-
777141777-
777141777-
777141777-
777141777-
777141777-
777141777-
000030000-
033330000-
030000000-
030033330-
030030030-
030030030-
033333330-
000030000-
000030000-
777141777-
777141777-
777141777-
777141777-
777141777-
000030007-
000033307-
033300307-
030300307-
030300307-
030300307-
033333307-
000300007-
000300007-
000400007-
000400007-
222222227-
000400007-
000400007-
777477777-
777477777-
777477777-
777477777-
777477777-
777477777-
000400077-
004440077-
004640077-
004440077-
000000077